Year,Name,Gold,Silver,Bronze,Total,GDP,Total Population
1896,Greece,10,18,19,47,,
1896,United States,11,7,2,20,,
1896,Germany,6,5,2,13,,
1896,France,5,4,2,11,,
1896,Great Britain,2,3,2,7,,
1896,Denmark,1,2,3,6,,
1896,Hungary,2,1,3,6,,
1896,Austria,2,1,2,5,,
1896,Switzerland,1,2,0,3,,
1896,Australia,2,0,0,2,,
1896,Mixed team,1,0,1,2,,
1900,France,27,38,37,102,,
1900,United States,19,14,15,48,,
1900,Great Britain,15,8,9,32,,
1900,Mixed team,8,5,6,19,,
1900,Belgium,6,7,4,17,,
1900,Switzerland,6,2,1,9,,
1900,Germany,4,3,2,9,,
1900,Denmark,1,3,2,6,,
1900,Austria,0,3,3,6,,
1900,Italy,3,2,0,5,,
1900,Norway,0,2,3,5,,
1900,Netherlands,0,2,3,5,,
1900,Australia,2,0,3,5,,
1900,Hungary,1,2,2,5,,
1900,India,0,2,0,2,,
1900,Cuba,1,1,0,2,,
1900,Canada,1,0,1,2,,
1900,Bohemia,0,1,1,2,,
1900,Luxembourg,1,0,0,1,,
1900,Spain,1,0,0,1,,
1900,Sweden,0,0,1,1,,
1904,United States,76,78,77,231,,
1904,Germany,4,5,6,15,,
1904,Canada,4,1,1,6,,
1904,Australia,0,3,1,4,,
1904,Hungary,2,1,1,4,,
1904,Mixed team,2,1,1,4,,
1904,Austria,1,1,1,3,,
1904,Cuba,3,0,0,3,,
1904,Switzerland,1,0,2,3,,
1904,Great Britain,1,1,0,2,,
1904,Greece,1,0,1,2,,
1904,Norway,2,0,0,2,,
1904,France,0,1,0,1,,
1908,Great Britain,56,51,39,146,,
1908,United States,23,12,12,47,,
1908,Sweden,8,6,11,25,,
1908,France,5,5,9,19,,
1908,Canada,3,3,10,16,,
1908,Germany,3,5,5,13,,
1908,Hungary,3,4,2,9,,
1908,Belgium,1,5,2,8,,
1908,Norway,2,3,3,8,,
1908,Australasia,1,2,2,5,,
1908,Finland,1,1,3,5,,
1908,Denmark,0,2,3,5,,
1908,Italy,2,2,0,4,,
1908,Greece,0,3,1,4,,
1908,Russian Empire,1,2,0,3,,
1908,Bohemia,0,0,2,2,,
1908,Netherlands,0,0,2,2,,
1908,South Africa,1,1,0,2,,
1908,Austria,0,0,1,1,,
1912,Sweden,24,24,17,65,,
1912,United States,26,19,19,64,,
1912,Great Britain,10,15,16,41,,
1912,Finland,9,8,9,26,,
1912,Germany,6,13,7,26,,
1912,France,7,5,3,15,,
1912,Denmark,1,6,5,12,,
1912,Norway,4,1,5,10,,
1912,Italy,5,1,2,8,,
1912,Canada,3,2,3,8,,
1912,Hungary,3,2,3,8,,
1912,Australasia,2,2,3,7,,
1912,South Africa,4,2,0,6,,
1912,Belgium,2,1,3,6,,
1912,Russian Empire,0,2,3,5,,
1912,Austria,0,2,2,4,,
1912,Netherlands,0,0,3,3,,
1912,Greece,1,0,1,2,,
1912,Switzerland,1,0,0,1,,
1920,United States,41,27,27,95,,
1920,Sweden,19,20,25,64,,
1920,Great Britain,14,16,13,43,,
1920,Belgium,16,12,14,42,,
1920,France,9,19,13,41,,
1920,Finland,15,10,9,34,,
1920,Norway,13,9,9,31,,
1920,Italy,13,5,5,23,,
1920,Denmark,3,9,1,13,,
1920,Netherlands,4,2,5,11,,
1920,Switzerland,2,2,7,11,,
1920,South Africa,3,4,3,10,,
1920,Canada,3,3,3,9,,
1920,Estonia,1,2,0,3,,
1920,Brazil,1,1,1,3,,
1920,Australia,0,2,1,3,,
1920,Czechoslovakia,0,0,2,2,,
1920,Japan,0,2,0,2,,
1920,Spain,0,2,0,2,,
1920,Greece,0,1,0,1,,
1920,Luxembourg,0,1,0,1,,
1920,New Zealand,0,0,1,1,,
1924,United States,45,27,27,99,,
1924,France,13,15,10,38,,
1924,Finland,14,13,10,37,,
1924,Great Britain,9,13,12,34,,
1924,Sweden,4,13,12,29,,
1924,Switzerland,7,8,10,25,,
1924,Italy,8,3,5,16,,
1924,Belgium,3,7,3,13,,
1924,Netherlands,4,1,5,10,,
1924,Czechoslovakia,1,4,5,10,,
1924,Norway,5,2,3,10,,
1924,Denmark,2,5,2,9,,
1924,Hungary,2,3,4,9,,
1924,Argentina,1,3,2,6,,
1924,Australia,3,1,2,6,,
1924,Estonia,1,1,4,6,,
1924,Canada,0,3,1,4,,
1924,Austria,0,3,1,4,,
1924,South Africa,1,1,1,3,,
1924,Poland,0,1,1,2,,
1924,Yugoslavia,2,0,0,2,,
1924,Japan,0,0,1,1,,
1924,New Zealand,0,0,1,1,,
1924,Haiti,0,0,1,1,,
1924,Portugal,0,0,1,1,,
1924,Romania,0,0,1,1,,
1924,Uruguay,1,0,0,1,,
1928,United States,22,18,16,56,,
1928,Germany,10,7,14,31,,
1928,Sweden,7,6,12,25,,
1928,Finland,8,8,9,25,,
1928,France,6,10,5,21,,
1928,Great Britain,3,10,7,20,,
1928,Italy,7,5,7,19,,
1928,Netherlands,6,9,4,19,,
1928,Switzerland,7,4,4,15,,
1928,Canada,4,4,7,15,,
1928,Czechoslovakia,2,5,2,9,,
1928,Hungary,4,5,0,9,,
1928,Argentina,3,3,1,7,,
1928,Denmark,3,1,2,6,,
1928,Poland,1,1,3,5,,
1928,Japan,2,2,1,5,,
1928,Yugoslavia,1,1,3,5,,
1928,Estonia,2,1,2,5,,
1928,Australia,1,2,1,4,,
1928,Norway,1,2,1,4,,
1928,Egypt,2,1,1,4,,
1928,South Africa,1,0,2,3,,
1928,Belgium,0,1,2,3,,
1928,Austria,2,0,1,3,,
1928,Ireland,1,0,0,1,,
1928,Haiti,0,1,0,1,,
1928,New Zealand,1,0,0,1,,
1928,Philippines,0,0,1,1,,
1928,Portugal,0,0,1,1,,
1928,Spain,1,0,0,1,,
1928,Chile,0,1,0,1,,
1928,Uruguay,1,0,0,1,,
1928,India,1,0,0,1,,
1932,United States,41,32,30,103,,
1932,Italy,12,12,12,36,,
1932,Finland,5,8,12,25,,
1932,Sweden,9,5,9,23,,
1932,Germany,3,12,5,20,,
1932,France,10,5,4,19,,
1932,Japan,7,7,4,18,,
1932,Great Britain,4,7,5,16,,
1932,Canada,2,5,8,15,,
1932,Hungary,6,4,5,15,,
1932,Netherlands,2,5,0,7,,
1932,Poland,2,1,4,7,,
1932,Denmark,0,3,3,6,,
1932,Austria,1,1,3,5,,
1932,South Africa,2,0,3,5,,
1932,Australia,3,1,1,5,,
1932,Argentina,3,1,0,4,,
1932,Czechoslovakia,1,2,1,4,,
1932,Philippines,0,0,3,3,,
1932,Mexico,0,2,0,2,,
1932,Ireland,2,0,0,2,,
1932,New Zealand,0,1,0,1,,
1932,Latvia,0,1,0,1,,
1932,Spain,0,0,1,1,,
1932,India,1,0,0,1,,
1932,Switzerland,0,1,0,1,,
1932,Uruguay,0,0,1,1,,
1936,Germany,33,26,30,89,,
1936,United States,24,20,12,56,,
1936,Italy,8,9,5,22,,
1936,Sweden,6,5,9,20,,
1936,Finland,7,6,6,19,,
1936,France,7,6,6,19,,
1936,Japan,6,4,8,18,,
1936,Netherlands,6,4,7,17,,
1936,Hungary,10,1,5,16,,
1936,Switzerland,1,9,5,15,,
1936,Great Britain,4,7,3,14,,
1936,Austria,4,6,3,13,,
1936,Canada,1,3,5,9,,
1936,Czechoslovakia,3,5,0,8,,
1936,Argentina,2,2,3,7,,
1936,Estonia,2,2,3,7,,
1936,Poland,0,3,3,6,,
1936,Norway,1,3,2,6,,
1936,Denmark,0,2,3,5,,
1936,Egypt,2,1,2,5,,
1936,Mexico,0,0,3,3,,
1936,Latvia,0,1,1,2,,
1936,Belgium,0,0,2,2,,
1936,Turkey,1,0,1,2,,
1936,South Africa,0,1,0,1,,
1936,India,1,0,0,1,,
1936,Romania,0,1,0,1,,
1936,Portugal,0,0,1,1,,
1936,Australia,0,0,1,1,,
1936,Philippines,0,0,1,1,,
1936,New Zealand,1,0,0,1,,
1936,Yugoslavia,0,1,0,1,,
1948,United States,38,27,19,84,,
1948,Sweden,16,11,17,44,,
1948,France,10,6,13,29,,
1948,Hungary,10,5,12,27,,
1948,Italy,8,11,8,27,,
1948,Great Britain,3,14,6,23,,
1948,Switzerland,5,10,5,20,,
1948,Denmark,5,7,8,20,,
1948,Finland,8,7,5,20,,
1948,Netherlands,5,2,9,16,,
1948,Australia,2,6,5,13,,
1948,Turkey,6,4,2,12,,
1948,Czechoslovakia,6,2,3,11,,
1948,Argentina,3,3,1,7,,
1948,Norway,1,3,3,7,,
1948,Belgium,2,2,3,7,,
1948,Egypt,2,2,1,5,,
1948,Mexico,2,1,2,5,,
1948,South Africa,2,1,1,4,,
1948,Austria,1,0,3,4,,
1948,Jamaica,1,2,0,3,,
1948,Canada,0,1,2,3,,
1948,Panama,0,0,2,2,,
1948,Portugal,0,1,1,2,,
1948,South Korea,0,0,2,2,,
1948,Uruguay,0,1,1,2,,
1948,Yugoslavia,0,2,0,2,,
1948,Iran,0,0,1,1,,
1948,Peru,1,0,0,1,,
1948,Poland,0,0,1,1,,
1948,Puerto Rico,0,0,1,1,,
1948,India,1,0,0,1,,
1948,Spain,0,1,0,1,,
1948,Cuba,0,1,0,1,,
1948,Ceylon,0,1,0,1,,
1948,Trinidad and Tobago,0,1,0,1,,
1948,Brazil,0,0,1,1,,
1952,United States,40,19,17,76,,"157,552,740"
1952,Soviet Union,22,30,19,71,,
1952,Hungary,16,10,16,42,,"9,504,000"
1952,Sweden,12,13,10,35,,"7,124,673"
1952,Germany,0,7,17,24,,"69,145,952"
1952,Finland,6,3,13,22,,"4,090,500"
1952,Italy,8,9,4,21,,"47,666,000"
1952,France,6,6,6,18,,"43,206,189"
1952,Switzerland,2,6,6,14,,"4,815,000"
1952,Czechoslovakia,7,3,3,13,,
1952,Australia,6,2,3,11,,"8,691,212"
1952,Great Britain,1,2,8,11,,
1952,South Africa,2,4,4,10,,"14,264,935"
1952,Japan,1,6,2,9,,"86,459,025"
1952,Iran,0,3,4,7,,"17,275,640"
1952,Denmark,2,1,3,6,,"4,334,000"
1952,Netherlands,0,5,0,5,,"10,389,292"
1952,Norway,3,2,0,5,,"3,327,728"
1952,Jamaica,2,3,0,5,,"1,426,095"
1952,Argentina,1,2,2,5,,"17,876,956"
1952,Poland,1,2,1,4,,"25,730,551"
1952,Belgium,2,2,0,4,,"8,730,405"
1952,Romania,1,1,2,4,,"16,630,000"
1952,Canada,1,2,0,3,,"14,785,584"
1952,Turkey,2,0,1,3,,"22,235,677"
1952,Brazil,1,0,2,3,,"56,557,783"
1952,Yugoslavia,1,2,0,3,,
1952,New Zealand,1,0,2,3,,"1,994,794"
1952,Chile,0,2,0,2,,"6,377,619"
1952,India,1,0,1,2,,"382,791,319"
1952,South Korea,0,0,2,2,,
1952,Trinidad and Tobago,0,0,2,2,,"662,850"
1952,Lebanon,0,1,1,2,,"1,439,529"
1952,Austria,0,1,1,2,,"6,927,772"
1952,Uruguay,0,0,2,2,,"2,252,965"
1952,Portugal,0,0,1,1,,"8,526,050"
1952,Egypt,0,0,1,1,,"22,223,309"
1952,Bulgaria,0,0,1,1,,"7,274,900"
1952,Spain,0,1,0,1,,"28,549,870"
1952,Mexico,0,1,0,1,,"30,144,317"
1952,Luxembourg,1,0,0,1,,"299,263"
1952,Venezuela,0,0,1,1,,"5,439,568"
1952,Ireland,0,1,0,1,,"2,952,156"
1956,Soviet Union,37,29,32,98,,
1956,United States,32,25,17,74,,"168,903,031"
1956,Australia,13,8,14,35,,"9,500,606"
1956,United Team of Germany,6,13,7,26,,
1956,Hungary,9,10,7,26,,"9,911,000"
1956,Italy,8,8,9,25,,"48,921,000"
1956,Great Britain,6,7,11,24,,
1956,Japan,4,10,5,19,,"90,766,211"
1956,Sweden,8,5,6,19,,"7,314,552"
1956,Finland,3,1,11,15,,"4,281,700"
1956,France,4,4,6,14,,"44,682,239"
1956,Romania,5,3,5,13,,"17,583,000"
1956,Poland,1,4,4,9,,"27,743,876"
1956,Turkey,3,2,2,7,,"24,877,395"
1956,Czechoslovakia,1,4,1,6,,
1956,Canada,2,1,3,6,,"16,445,087"
1956,Iran,2,2,1,5,,"19,261,174"
1956,Bulgaria,1,3,1,5,,"7,575,800"
1956,Ireland,1,1,3,5,,"2,895,253"
1956,Denmark,1,2,1,4,,"4,466,471"
1956,South Africa,0,0,4,4,,"15,755,233"
1956,Chile,0,2,2,4,,"6,888,843"
1956,Norway,1,0,2,3,,"3,459,992"
1956,Yugoslavia,0,3,0,3,,
1956,New Zealand,2,0,0,2,,"2,178,289"
1956,Mexico,1,0,1,2,,"33,945,886"
1956,South Korea,0,1,1,2,,
1956,Belgium,0,2,0,2,,"8,923,845"
1956,Austria,0,0,2,2,,"6,952,359"
1956,Argentina,0,1,1,2,,"19,271,511"
1956,Pakistan,0,1,0,1,,"46,679,944"
1956,India,1,0,0,1,,"411,946,698"
1956,Iceland,0,1,0,1,,"161,358"
1956,Greece,0,0,1,1,,"8,031,013"
1956,Brazil,1,0,0,1,,"63,481,099"
1956,Switzerland,0,0,1,1,,"5,045,000"
1956,Bahamas,0,0,1,1,,
1956,Uruguay,0,0,1,1,,"2,389,290"
1960,Soviet Union,43,29,31,103,,
1960,United States,34,21,16,71,3441682234966.81,"180,671,158"
1960,United Team of Germany,12,19,11,42,,
1960,Italy,13,10,13,36,626952585229.25,"50,197,600"
1960,Australia,8,8,6,22,206734197138.169,"10,361,273"
1960,Poland,4,6,11,21,,"29,589,842"
1960,Hungary,6,8,7,21,,"9,983,512"
1960,Great Britain,2,6,12,20,,
1960,Japan,4,7,7,18,971582862679.811,"94,091,638"
1960,Romania,3,1,6,10,,"18,403,414"
1960,Turkey,7,2,0,9,93150195819.4396,"28,217,122"
1960,Czechoslovakia,3,2,3,8,,
1960,Bulgaria,1,3,3,7,,"7,867,374"
1960,Switzerland,0,3,3,6,,"5,362,000"
1960,Denmark,2,3,1,6,108492979143.333,"4,581,000"
1960,Sweden,1,2,3,6,149620019088.711,"7,480,395"
1960,Finland,1,1,3,5,59862320225.3108,"4,429,600"
1960,France,0,2,3,5,684477080169.693,"46,611,574"
1960,Iran,0,1,3,4,,"21,599,749"
1960,Belgium,0,2,2,4,133384673232.843,"9,118,700"
1960,South Africa,0,1,2,3,87183503348.5854,"17,416,653"
1960,Netherlands,0,1,2,3,201307886826.394,"11,493,806"
1960,New Zealand,2,0,1,3,,"2,371,746"
1960,Pakistan,1,0,1,2,15153512114.6599,"51,718,581"
1960,Argentina,0,1,1,2,120808873523.837,"20,616,009"
1960,Yugoslavia,1,1,0,2,,
1960,Austria,1,1,0,2,99489765786.6089,"7,047,437"
1960,Brazil,0,0,2,2,286196738836.702,"71,411,679"
1960,British West Indies,0,0,2,2,,
1960,Egypt,0,1,1,2,,"26,846,610"
1960,Ethiopia,1,0,0,1,,"24,168,672"
1960,Venezuela,0,0,1,1,,"7,556,483"
1960,Canada,0,1,0,1,354403586127.522,"18,266,765"
1960,Spain,0,0,1,1,275635620736.643,"30,641,187"
1960,Morocco,0,1,0,1,,"12,451,245"
1960,Mexico,0,0,1,1,162201552099.831,"38,578,505"
1960,Singapore,0,1,0,1,6708521322.33417,"1,646,400"
1960,Greece,1,0,0,1,63749159946.9305,"8,327,405"
1960,Republic of China,0,1,0,1,,
1960,Portugal,0,1,0,1,44908647744.8968,"9,036,700"
1960,India,0,1,0,1,158834744856.639,"445,393,249"
1960,Iraq,0,0,1,1,,"6,822,030"
1960,Norway,1,0,0,1,90717226410.1182,"3,581,239"
1960,Ghana,0,1,0,1,7544822191.56204,"6,958,283"
1964,Soviet Union,30,31,35,96,,
1964,United States,36,26,28,90,4307726999184.04,"191,888,791"
1964,United Team of Germany,10,22,18,50,,
1964,Japan,16,5,8,29,1377969967687.15,"97,826,267"
1964,Italy,10,10,7,27,744957429552.39,"51,600,200"
1964,Poland,7,6,10,23,,"30,975,520"
1964,Hungary,10,7,5,22,,"10,124,000"
1964,Great Britain,4,12,2,18,,
1964,Australia,6,2,10,18,254892994999.378,"11,218,304"
1964,France,1,8,6,15,846739845823.178,"49,387,606"
1964,Czechoslovakia,5,6,3,14,,
1964,Romania,2,4,6,12,,"18,927,081"
1964,Bulgaria,3,5,2,10,,"8,144,339"
1964,Netherlands,2,4,4,10,252114551476.487,"12,136,006"
1964,Sweden,2,2,4,8,178429017363.201,"7,661,354"
1964,Turkey,2,3,1,6,122519608002.794,"31,227,361"
1964,Denmark,2,1,3,6,128159079420.128,"4,720,171"
1964,New Zealand,3,0,2,5,,"2,591,950"
1964,Yugoslavia,2,1,2,5,,
1964,Finland,3,0,2,5,70144152940.6732,"4,548,544"
1964,Switzerland,1,2,1,4,,"5,887,000"
1964,Canada,1,2,1,4,451698849392.536,"19,711,053"
1964,South Korea,0,2,1,3,,
1964,Belgium,2,0,1,3,159038316308.665,"9,367,000"
1964,Trinidad and Tobago,0,1,2,3,4740912943.75436,"923,887"
1964,Tunisia,0,1,1,2,5234649503.98211,"4,468,393"
1964,Iran,0,0,2,2,,"24,299,823"
1964,Cuba,0,1,0,1,,"7,612,275"
1964,Uruguay,0,0,1,1,14982694335.3787,"2,663,610"
1964,Bahamas,1,0,0,1,,
1964,Brazil,0,0,1,1,320663950240.226,"80,221,304"
1964,Ireland,0,0,1,1,,"2,864,000"
1964,Ethiopia,1,0,0,1,,"26,192,357"
1964,Philippines,0,1,0,1,37494559779.6482,"31,459,863"
1964,Pakistan,0,1,0,1,20695602650.0708,"57,494,940"
1964,Nigeria,0,0,1,1,73684152215.8791,"46,702,388"
1964,Ghana,0,0,1,1,7813960756.81338,"7,781,813"
1964,India,1,0,0,1,176037689338.708,"484,050,037"
1964,Mexico,0,0,1,1,222971202539.928,"43,774,575"
1964,Kenya,0,0,1,1,5887051209.2518,"9,247,518"
1964,Argentina,0,1,0,1,138381639345.114,"21,949,244"
1968,United States,45,28,34,107,4758686862300.0,"200,706,052"
1968,Soviet Union,29,32,30,91,,
1968,Hungary,10,10,12,32,,"10,263,542"
1968,West Germany,5,11,10,26,,
1968,Japan,11,7,7,25,1951224678933.53,"101,960,672"
1968,East Germany,9,9,7,25,,
1968,Poland,5,2,11,18,,"32,034,813"
1968,Australia,5,7,5,17,326687853950.911,"12,101,660"
1968,Italy,3,4,9,16,950117939348.408,"52,986,600"
1968,Romania,4,6,5,15,,"19,720,984"
1968,France,7,3,5,15,1038354070752.8,"51,068,762"
1968,Czechoslovakia,7,2,4,13,,
1968,Great Britain,5,5,3,13,,
1968,Bulgaria,2,4,3,9,,"8,369,603"
1968,Mexico,3,3,3,9,284464479176.938,"49,518,803"
1968,Kenya,3,4,2,9,6763403165.32304,"10,532,389"
1968,Yugoslavia,3,3,2,8,,
1968,Denmark,1,4,3,8,150533749283.215,"4,867,300"
1968,Netherlands,3,3,1,7,319699562077.53,"12,734,645"
1968,Canada,1,3,1,5,528304615337.633,"21,143,100"
1968,Iran,2,1,2,5,,"27,372,872"
1968,Switzerland,0,1,4,5,,"6,132,000"
1968,Finland,1,2,1,4,84635320495.2761,"4,626,469"
1968,Austria,0,2,2,4,146159747322.549,"7,415,403"
1968,Cuba,0,4,0,4,,"8,283,933"
1968,Mongolia,0,1,3,4,,"1,181,000"
1968,Sweden,2,1,1,4,213141173401.083,"7,912,217"
1968,Brazil,0,1,2,3,447443002845.25,"89,926,300"
1968,New Zealand,1,0,2,3,,"2,759,000"
1968,Belgium,0,1,1,2,193792194112.927,"9,589,800"
1968,Uganda,0,1,1,2,,"9,170,101"
1968,Turkey,2,0,0,2,147218243164.808,"34,164,759"
1968,Tunisia,1,0,1,2,6346925527.45564,"4,894,178"
1968,Argentina,0,0,2,2,169174227931.948,"23,260,514"
1968,South Korea,0,1,1,2,,
1968,Norway,1,1,0,2,125059553530.953,"3,818,983"
1968,Ethiopia,1,1,0,2,,"28,451,255"
1968,Cameroon,0,1,0,1,6063911795.34387,"6,459,744"
1968,Republic of China,0,0,1,1,,
1968,India,0,0,1,1,219861632830.604,"529,361,738"
1968,Pakistan,1,0,0,1,27481425962.2594,"63,969,987"
1968,Venezuela,1,0,0,1,,"10,041,225"
1968,Jamaica,0,1,0,1,8595347631.08298,"1,893,477"
1968,Greece,0,0,1,1,117755967331.064,"8,740,765"
1972,Soviet Union,50,27,22,99,,
1972,United States,33,31,30,94,5436461589500.0,"209,896,021"
1972,East Germany,20,23,23,66,,
1972,West Germany,13,11,16,40,,
1972,Hungary,6,13,16,35,,"10,394,091"
1972,Japan,13,8,8,29,2363383219485.1,"107,188,273"
1972,Poland,7,5,9,21,,"33,039,545"
1972,Bulgaria,6,10,5,21,,"8,576,200"
1972,Italy,5,3,10,18,1133675656587.3,"54,365,564"
1972,Great Britain,4,5,9,18,,
1972,Australia,8,7,2,17,377155458071.398,"13,177,000"
1972,Romania,3,6,7,16,,"20,662,648"
1972,Sweden,4,6,6,16,236129464049.664,"8,122,293"
1972,France,2,4,7,13,1267680569981.33,"52,933,025"
1972,Kenya,2,3,4,9,10661654644.0086,"12,044,785"
1972,Cuba,3,1,4,8,23304302372.9267,"8,830,355"
1972,Czechoslovakia,2,4,2,8,,
1972,Finland,3,1,4,8,103081130725.907,"4,639,657"
1972,North Korea,1,1,3,5,,
1972,Netherlands,3,1,1,5,376604439577.563,"13,340,427"
1972,Yugoslavia,2,1,2,5,,
1972,Canada,0,2,3,5,639469707972.224,"22,284,500"
1972,Norway,2,1,1,4,151216171096.098,"3,933,004"
1972,Iran,0,2,1,3,,"30,685,055"
1972,Austria,0,1,2,3,177900244807.952,"7,544,201"
1972,New Zealand,1,1,1,3,70330524699.7241,"2,929,100"
1972,Switzerland,0,3,0,3,344126601258.905,"6,401,400"
1972,Colombia,0,1,2,3,79546065417.5547,"22,542,890"
1972,Greece,0,2,0,2,141476895274.227,"8,888,628"
1972,Belgium,0,2,0,2,236034247405.179,"9,709,100"
1972,Uganda,1,1,0,2,,"10,156,091"
1972,Brazil,0,0,2,2,693512655666.751,"99,901,025"
1972,Ethiopia,0,0,2,2,,"30,770,372"
1972,South Korea,0,1,0,1,,
1972,Turkey,0,1,0,1,182045620414.76,"37,492,953"
1972,Tunisia,0,1,0,1,8870910716.78077,"5,303,507"
1972,Spain,0,0,1,1,590055811943.231,"34,513,161"
1972,Pakistan,0,1,0,1,30856056462.9726,"71,121,085"
1972,Denmark,1,0,0,1,165863095709.072,"4,991,596"
1972,Jamaica,0,0,1,1,9407069695.69226,"1,997,616"
1972,Nigeria,0,0,1,1,131677009276.205,"59,042,114"
1972,Niger,0,0,1,1,2471543538.41681,"5,060,262"
1972,Ghana,0,0,1,1,10605539527.4848,"9,285,663"
1972,Mongolia,0,1,0,1,,"1,320,500"
1972,Mexico,0,1,0,1,364474097749.844,"55,984,294"
1972,Lebanon,0,1,0,1,,"2,513,207"
1972,India,0,0,1,1,232282272994.879,"579,509,428"
1972,Argentina,0,1,0,1,197100011389.723,"24,779,799"
1976,Soviet Union,49,41,35,125,,
1976,United States,34,35,25,94,6313127560800.0,"218,035,164"
1976,East Germany,40,25,25,90,,
1976,West Germany,10,12,17,39,,
1976,Romania,4,9,14,27,,"21,445,698"
1976,Poland,7,6,13,26,,"34,299,428"
1976,Japan,9,6,10,25,2783935217060.86,"112,774,841"
1976,Hungary,4,5,13,22,,"10,588,729"
1976,Bulgaria,6,9,7,22,,"8,755,037"
1976,Cuba,6,4,3,13,31168861184.8217,"9,417,729"
1976,Great Britain,3,5,5,13,,
1976,Italy,2,7,4,13,1259030532413.65,"55,838,536"
1976,Canada,0,5,6,11,736747853671.715,"23,517,500"
1976,France,2,3,4,9,1409534980791.88,"54,203,213"
1976,Czechoslovakia,2,2,4,8,,
1976,Yugoslavia,2,3,3,8,,
1976,Finland,4,2,0,6,108637157806.075,"4,725,664"
1976,South Korea,1,1,4,6,,
1976,Belgium,0,3,3,6,252996053674.129,"9,811,000"
1976,Sweden,4,1,0,5,245031407840.117,"8,222,310"
1976,Netherlands,0,2,3,5,414184611625.892,"13,781,093"
1976,Australia,0,1,4,5,409888764605.755,"13,915,500"
1976,New Zealand,2,1,1,4,67221321774.4381,"3,153,550"
1976,Switzerland,1,1,2,4,323558775216.586,"6,333,313"
1976,Denmark,1,0,2,3,180295212457.16,"5,072,596"
1976,Jamaica,1,1,0,2,8522868312.31612,"2,133,388"
1976,Brazil,0,0,2,2,865053643933.736,"110,207,259"
1976,Spain,0,2,0,2,639471970413.889,"35,996,780"
1976,North Korea,1,1,0,2,,
1976,Iran,0,1,1,2,,"34,475,327"
1976,Mexico,1,0,1,2,453349962679.757,"62,219,964"
1976,Portugal,0,2,0,2,109491763347.506,"9,621,970"
1976,Norway,1,1,0,2,181706786074.728,"4,026,152"
1976,Puerto Rico,0,0,1,1,43030395565.8295,"3,026,125"
1976,Austria,0,0,1,1,194374964316.0,"7,565,525"
1976,Pakistan,0,0,1,1,37977319757.9899,"78,152,686"
1976,Thailand,0,0,1,1,60017995792.2658,"43,221,022"
1976,Trinidad and Tobago,1,0,0,1,7915354999.60433,"1,021,480"
1976,Venezuela,0,1,0,1,,"13,082,017"
1976,Bermuda,0,0,1,1,3028619303.83456,"54,018"
1976,Mongolia,0,1,0,1,,"1,487,150"
1980,Soviet Union,80,69,46,195,,
1980,East Germany,47,37,42,126,,
1980,Bulgaria,8,16,17,41,30667386625.1523,"8,843,528"
1980,Hungary,7,10,15,32,,"10,711,122"
1980,Poland,3,14,15,32,,"35,578,016"
1980,Romania,6,6,13,25,,"22,130,036"
1980,Great Britain,5,7,9,21,,
1980,Cuba,8,7,5,20,39082746853.6651,"9,647,550"
1980,Italy,8,3,4,15,1397220277176.56,"56,451,247"
1980,Czechoslovakia,2,3,9,14,,
1980,France,6,5,3,14,1536008235461.47,"55,163,167"
1980,Sweden,3,3,6,12,263188803358.157,"8,310,473"
1980,Yugoslavia,2,3,4,9,,
1980,Australia,2,2,5,9,469182358833.87,"14,534,756"
1980,Finland,3,1,4,8,128069196072.583,"4,779,535"
1980,Spain,1,3,2,6,661140958805.749,"37,488,360"
1980,North Korea,0,3,2,5,,
1980,Denmark,2,1,2,5,191946178882.75,"5,123,027"
1980,Brazil,2,0,2,4,969050273738.546,"121,455,806"
1980,Austria,1,2,1,4,212216351195.68,"7,549,433"
1980,Ethiopia,2,0,2,4,8302969570.96223,"36,036,457"
1980,Mexico,0,1,3,4,586478778503.066,"68,347,479"
1980,Mongolia,0,2,2,4,2705613731.30717,"1,655,269"
1980,Greece,1,0,2,3,179661448556.809,"9,642,505"
1980,Netherlands,0,1,2,3,419570276663.826,"14,155,285"
1980,Jamaica,0,0,3,3,8329388788.64095,"2,228,803"
1980,Ireland,0,1,1,2,63266067370.0433,"3,401,000"
1980,Switzerland,2,0,0,2,347821247668.926,"6,385,229"
1980,Tanzania,0,2,0,2,,"18,654,562"
1980,Uganda,0,1,0,1,,"12,106,227"
1980,Venezuela,0,1,0,1,,"14,767,890"
1980,Belgium,1,0,0,1,271274619027.925,"9,846,800"
1980,Guyana,0,0,1,1,1383267660.56763,"759,352"
1980,Lebanon,0,0,1,1,,"2,901,188"
1980,India,1,0,0,1,324234528873.41,"684,887,703"
1980,Zimbabwe,1,0,0,1,10859909746.198,"7,169,968"
1984,United States,83,61,30,174,7906433457700.0,"235,824,902"
1984,West Germany,17,19,23,59,,
1984,Romania,20,16,17,53,,"22,453,788"
1984,Canada,10,18,16,44,909037016484.508,"25,701,800"
1984,Great Britain,5,11,21,37,,
1984,China,15,8,9,32,615440492473.827,"1,046,459,302"
1984,Italy,14,6,12,32,1542883437376.7,"56,687,144"
1984,Japan,10,8,14,32,3823839017632.46,"120,034,697"
1984,France,5,7,16,28,1641719936320.68,"56,312,924"
1984,Australia,4,8,12,24,525350244893.651,"15,338,734"
1984,South Korea,6,6,7,19,,
1984,Sweden,2,11,6,19,293258993521.7,"8,342,621"
1984,Yugoslavia,7,4,7,18,,
1984,Netherlands,5,2,6,13,465373242048.681,"14,433,533"
1984,Finland,4,2,6,12,144979447530.263,"4,881,788"
1984,New Zealand,8,1,2,11,82894059292.5485,"3,298,090"
1984,Brazil,1,5,2,8,1148585088075.65,"133,409,299"
1984,Switzerland,0,4,4,8,380769056936.784,"6,532,311"
1984,Mexico,2,3,1,6,579726773526.627,"74,943,413"
1984,Denmark,0,3,3,6,223809522099.19,"5,111,619"
1984,Spain,1,2,2,5,723548150160.144,"38,362,861"
1984,Belgium,1,1,2,4,288604229888.201,"9,855,300"
1984,Kenya,1,0,2,3,17735121267.6206,"19,046,177"
1984,Jamaica,0,1,2,3,8264174537.79611,"2,338,197"
1984,Portugal,1,0,2,3,131671393389.222,"9,885,387"
1984,Turkey,0,0,3,3,297566581365.025,"49,830,462"
1984,Venezuela,0,0,3,3,,"16,689,995"
1984,Austria,1,1,1,3,229258275343.493,"7,554,132"
1984,Norway,0,1,2,3,244552114231.352,"4,140,095"
1984,Puerto Rico,0,1,1,2,53961209439.9481,"3,350,037"
1984,Algeria,0,0,2,2,88918875921.9762,"21,340,546"
1984,Nigeria,0,1,1,2,114309873981.56,"83,165,888"
1984,Morocco,2,0,0,2,36413145449.7067,"21,418,412"
1984,Greece,0,1,1,2,186808656263.818,"9,915,459"
1984,Peru,0,1,0,1,70652538143.647,"18,973,705"
1984,Pakistan,1,0,0,1,63588796957.6813,"98,862,614"
1984,Ivory Coast,0,1,0,1,,
1984,Ireland,0,1,0,1,67600990729.7376,"3,529,000"
1984,Iceland,0,0,1,1,7466357146.24641,"239,498"
1984,Syria,0,1,0,1,,"10,100,847"
1984,Thailand,0,1,0,1,91514384420.51,"50,861,767"
1984,Egypt,0,1,0,1,,"48,550,155"
1984,Dominican Republic,0,0,1,1,17359736944.586,"6,233,866"
1984,Colombia,0,1,0,1,124927968733.784,"29,765,372"
1984,Chinese Taipei,0,0,1,1,,
1984,Cameroon,0,0,1,1,19015357944.8201,"9,777,830"
1984,Zambia,0,0,1,1,7803889933.50149,"6,344,722"
1988,Soviet Union,55,31,46,132,,
1988,East Germany,37,35,30,102,,
1988,United States,36,31,27,94,9001231051100.0,"244,498,982"
1988,West Germany,11,14,15,40,,
1988,Bulgaria,10,12,13,35,36292630364.1532,"8,982,025"
1988,South Korea,12,10,11,33,,
1988,China,5,11,12,28,827732227234.598,"1,117,284,539"
1988,Great Britain,5,10,9,24,,
1988,Romania,7,11,6,24,,"22,768,897"
1988,Hungary,11,6,6,23,,"10,442,500"
1988,France,6,4,6,16,1894061230965.3,"57,335,273"
1988,Poland,2,5,9,16,,"37,866,840"
1988,Australia,3,6,5,14,612854394107.81,"16,183,270"
1988,Japan,4,3,7,14,4703605002001.88,"122,613,000"
1988,Italy,6,4,4,14,1749180429217.39,"56,711,103"
1988,New Zealand,3,2,8,13,83664727854.3511,"3,361,313"
1988,Yugoslavia,3,4,5,12,,
1988,Sweden,0,4,7,11,321511422218.61,"8,469,339"
1988,Canada,3,2,5,10,1012322457812.92,"26,894,800"
1988,Kenya,5,2,2,9,21765118854.9204,"21,875,798"
1988,Netherlands,2,2,5,9,533807104249.637,"14,774,965"
1988,Czechoslovakia,3,3,2,8,,
1988,Brazil,1,2,3,6,1189604001251.3,"144,963,227"
1988,Norway,2,3,0,5,255627885399.145,"4,208,729"
1988,Spain,1,1,2,4,873144007866.8,"39,053,881"
1988,Denmark,2,1,1,4,229126577437.179,"5,129,516"
1988,Switzerland,0,2,2,4,432100120508.07,"6,709,508"
1988,Finland,1,1,2,4,167119851165.76,"4,946,633"
1988,Morocco,1,0,2,3,43185385081.897,"23,526,173"
1988,Turkey,1,1,0,2,365299342385.855,"54,356,391"
1988,Argentina,0,1,1,2,203726588308.536,"32,099,320"
1988,Mexico,0,0,2,2,653984125355.572,"81,540,513"
1988,Belgium,0,0,2,2,329971688233.146,"9,884,000"
1988,Jamaica,0,2,0,2,10349125248.5975,"2,422,363"
1988,Djibouti,0,0,1,1,,"414,997"
1988,Austria,1,0,0,1,260194624813.073,"7,599,791"
1988,Virgin Islands,0,1,0,1,,
1988,Chile,0,1,0,1,78761086957.4583,"12,554,615"
1988,Thailand,0,0,1,1,141610545731.926,"54,382,553"
1988,Colombia,0,0,1,1,147727919256.512,"32,768,734"
1988,Costa Rica,0,1,0,1,15237191210.1453,"2,873,985"
1988,Suriname,1,0,0,1,2465914165.6507,"411,262"
1988,Netherlands Antilles,0,1,0,1,,
1988,Mongolia,0,0,1,1,3846754148.22336,"1,992,349"
1988,Indonesia,0,1,0,1,309821137734.337,"175,334,750"
1988,Senegal,0,1,0,1,8057233656.89141,"6,912,268"
1988,Iran,0,1,0,1,,"53,835,124"
1988,Portugal,1,0,0,1,166592605206.496,"9,920,611"
1988,Philippines,0,0,1,1,94520033471.8569,"58,639,099"
1988,Peru,0,1,0,1,58494020190.3879,"20,671,423"
1988,Pakistan,0,0,1,1,79876151981.2353,"110,446,491"
1988,Greece,0,0,1,1,197653949750.543,"10,049,498"
1992,Unified Team,45,38,29,112,,
1992,United States,37,34,37,108,9949782934400.0,"256,514,224"
1992,Germany,33,21,28,82,2792449673947.87,"80,597,764"
1992,China,16,22,16,54,1330126636882.84,"1,182,401,140"
1992,Cuba,14,6,11,31,30274202861.8866,"10,780,322"
1992,Hungary,11,12,7,30,91148741570.0527,"10,383,053"
1992,South Korea,12,5,12,29,,
1992,France,8,5,16,29,1977870042656.88,"58,991,464"
1992,Australia,7,9,11,27,663031927492.837,"17,201,463"
1992,Spain,13,7,2,22,915687331433.623,"39,552,425"
1992,Japan,3,8,11,22,4928660123396.16,"124,378,689"
1992,Great Britain,5,3,12,20,,
1992,Italy,6,5,8,19,1813829506032.43,"56,908,936"
1992,Poland,3,6,10,19,236002802390.66,"38,370,697"
1992,Romania,4,6,8,18,104627669365.45,"22,797,027"
1992,Canada,7,4,7,18,1072894090474.23,"28,544,892"
1992,Bulgaria,3,7,6,16,30906937186.95,"8,658,506"
1992,Netherlands,2,6,7,15,579826010155.08,"15,189,788"
1992,Sweden,1,7,4,12,320231800328.106,"8,718,867"
1992,New Zealand,1,4,5,10,93560795615.5385,"3,493,554"
1992,North Korea,4,0,5,9,,
1992,Kenya,2,4,2,8,22557679339.9403,"24,903,565"
1992,Czechoslovakia,4,2,1,7,,
1992,Norway,2,4,1,7,294888524869.709,"4,286,358"
1992,Turkey,2,2,2,6,396606335166.812,"58,501,681"
1992,Denmark,1,1,4,6,249523747816.308,"5,171,393"
1992,Indonesia,2,2,1,5,404000352342.249,"187,915,916"
1992,Finland,1,2,2,5,156835695262.809,"5,041,039"
1992,Nigeria,0,3,1,4,145693698761.128,"101,837,787"
1992,Jamaica,0,3,1,4,12271176912.1473,"2,540,150"
1992,Latvia,0,2,1,3,,"2,613,118"
1992,Croatia,0,1,2,3,,"4,490,682"
1992,Independent Olympic Participants,0,1,2,3,,
1992,Iran,0,1,2,3,,"61,387,591"
1992,Brazil,2,1,0,3,1325134726637.11,"155,563,895"
1992,Ethiopia,1,0,2,3,9866455689.20831,"50,992,777"
1992,Belgium,0,1,2,3,348785422253.304,"10,045,622"
1992,Morocco,1,1,1,3,49758715929.222,"25,442,561"
1992,Namibia,0,2,0,2,5831191371.21901,"1,538,529"
1992,South Africa,0,2,0,2,225677485788.197,"40,116,478"
1992,Algeria,1,0,1,2,89763654164.5903,"26,493,628"
1992,Mongolia,0,0,2,2,3152092285.02233,"2,210,189"
1992,Lithuania,1,0,1,2,,"3,617,607"
1992,Slovenia,0,0,2,2,28790603318.003,"1,999,210"
1992,Israel,0,1,1,2,129617733787.029,"4,821,920"
1992,Ireland,1,1,0,2,97745997381.35,"3,557,761"
1992,Greece,2,0,0,2,205962855046.137,"10,442,232"
1992,Estonia,1,0,1,2,,"1,528,715"
1992,Austria,0,2,0,2,282867273580.389,"7,914,969"
1992,Switzerland,1,0,0,1,432843636283.607,"7,000,610"
1992,Suriname,0,0,1,1,2452925148.36052,"424,123"
1992,Bahamas,0,0,1,1,,
1992,Thailand,0,0,1,1,194249907286.591,"57,224,800"
1992,Colombia,0,0,1,1,174830361367.88,"35,898,123"
1992,Qatar,0,0,1,1,,"463,511"
1992,Puerto Rico,0,0,1,1,71450561258.2688,"3,585,176"
1992,Philippines,0,0,1,1,100510800776.545,"64,119,361"
1992,Peru,0,1,0,1,70290744141.8621,"22,502,571"
1992,Pakistan,0,0,1,1,95412089507.6067,"122,147,910"
1992,Malaysia,0,0,1,1,117103066250.66,"18,958,826"
1992,Argentina,0,0,1,1,274830720366.623,"33,966,873"
1992,Ghana,0,0,1,1,14271065398.603,"15,651,777"
1992,Chinese Taipei,0,1,0,1,,
1992,Mexico,0,1,0,1,754925835085.174,"87,804,312"
1996,United States,44,32,25,101,11570064189000.0,"269,394,284"
1996,Germany,20,18,27,65,2974922531539.87,"81,890,667"
1996,Russia,26,21,16,63,,"149,563,044"
1996,China,16,22,12,50,1910919239036.1,"1,233,877,275"
1996,Australia,9,9,23,41,777552637827.885,"17,978,388"
1996,France,15,7,15,37,2171138280548.45,"60,130,949"
1996,Italy,13,10,12,35,1955997581478.94,"57,406,046"
1996,South Korea,7,15,5,27,,
1996,Cuba,9,8,8,25,34435290193.9529,"10,962,801"
1996,Ukraine,9,2,12,23,84589906068.8543,"50,813,392"
1996,Canada,3,11,8,22,1213040838740.83,"30,026,324"
1996,Hungary,7,4,10,21,99659709186.8409,"10,259,301"
1996,Romania,4,7,9,20,107662097567.873,"22,622,471"
1996,Netherlands,4,5,10,19,675711369178.015,"15,545,307"
1996,Poland,7,5,5,17,298139820250.058,"38,629,840"
1996,Spain,5,6,6,17,1044886132833.35,"39,820,561"
1996,Bulgaria,3,7,5,15,33676864762.4205,"8,204,087"
1996,Brazil,3,3,9,15,1467161088733.51,"165,745,963"
1996,Belarus,1,6,8,15,26266750331.3539,"10,170,664"
1996,Great Britain,1,8,6,15,,
1996,Japan,3,6,5,14,5217421238313.45,"125,616,709"
1996,Czech Republic,4,3,4,11,143571688505.491,
1996,Kazakhstan,3,4,4,11,59283829183.1558,"16,236,550"
1996,Sweden,2,4,2,8,362772883106.3,"8,892,234"
1996,Greece,4,4,0,8,234808508199.108,"10,689,910"
1996,Kenya,1,4,3,8,25455617585.0165,"27,720,870"
1996,Switzerland,4,3,0,7,460886576236.655,"7,188,778"
1996,Norway,2,2,3,7,348541516288.432,"4,381,278"
1996,Jamaica,1,3,2,6,12112650833.8266,"2,680,135"
1996,Nigeria,2,1,3,6,160182746695.232,"112,744,016"
1996,New Zealand,3,2,1,6,104422242785.469,"3,697,013"
1996,Denmark,4,1,1,6,279219103585.923,"5,262,075"
1996,Belgium,2,2,2,6,383686379912.252,"10,178,934"
1996,Turkey,4,1,1,6,505647959980.986,"62,233,516"
1996,North Korea,2,1,2,5,,
1996,South Africa,3,1,1,5,250233021708.004,"42,778,823"
1996,Indonesia,1,1,2,4,428759443957.882,"200,984,462"
1996,Finland,1,2,1,4,189776780339.204,"5,120,310"
1996,Ireland,3,0,1,4,138755064481.791,"3,636,179"
1996,Yugoslavia,1,1,2,4,,
1996,Slovakia,1,1,1,3,,"5,373,190"
1996,Algeria,2,0,1,3,103062925254.282,"28,837,600"
1996,Ethiopia,2,0,1,3,11721244257.5256,"56,817,472"
1996,Austria,0,1,2,3,314328689139.021,"8,060,851"
1996,Argentina,0,2,1,3,316350941905.026,"35,682,983"
1996,Iran,1,1,1,3,,"63,434,648"
1996,Portugal,1,0,1,2,205309962792.9,"10,099,917"
1996,Armenia,1,1,0,2,3940491000.05925,"3,120,069"
1996,Uzbekistan,0,1,1,2,18623602238.0718,"23,523,857"
1996,Trinidad and Tobago,0,0,2,2,10738002278.5196,"1,250,028"
1996,Thailand,1,0,1,2,199312314682.614,"59,403,003"
1996,Croatia,1,1,0,2,45500387340.8512,"4,445,463"
1996,Slovenia,0,2,0,2,33685428176.1259,"2,007,428"
1996,Georgia,0,0,2,2,6043360994.22095,"4,965,838"
1996,Malaysia,0,1,1,2,140663697153.146,"21,034,542"
1996,Moldova,0,1,1,2,4286715575.55189,"4,333,973"
1996,Morocco,0,0,2,2,55836249260.847,"27,130,551"
1996,Namibia,0,2,0,2,6730205700.92531,"1,702,428"
1996,India,0,0,1,1,772701320024.783,"976,203,090"
1996,Philippines,0,1,0,1,116463102215.322,"70,074,474"
1996,Mongolia,0,0,1,1,3680563574.14778,"2,340,705"
1996,Azerbaijan,0,1,0,1,11189158287.0384,"8,138,330"
1996,Uganda,0,0,1,1,8890982814.5195,"20,388,245"
1996,Bahamas,0,1,0,1,,
1996,Tunisia,0,0,1,1,26242594452.9831,"9,122,126"
1996,Mozambique,0,0,1,1,4227816690.59955,"17,047,073"
1996,Tonga,0,1,0,1,299209506.029536,"97,564"
1996,Syria,1,0,0,1,,"14,865,707"
1996,Burundi,1,0,0,1,1489759038.01604,"5,814,684"
1996,Chinese Taipei,0,1,0,1,,
1996,Costa Rica,1,0,0,1,22660897078.8244,"3,535,531"
1996,Lithuania,0,0,1,1,23637117966.243,"3,500,537"
1996,Ecuador,1,0,0,1,48244078213.3422,"11,600,867"
1996,Latvia,0,1,0,1,15178603564.9892,"2,452,526"
1996,Mexico,0,0,1,1,848741697521.206,"94,125,591"
1996,Israel,0,0,1,1,156653620470.851,"5,513,045"
1996,Hong Kong,1,0,0,1,,"6,388,452"
1996,Puerto Rico,0,0,1,1,84592384061.8031,"3,724,655"
1996,Zambia,0,1,0,1,9088657605.63674,"9,054,053"
2000,United States,37,24,32,93,12968262715400.0,"282,162,411"
2000,Russia,32,28,29,89,,"148,020,170"
2000,China,28,16,14,58,2639112188146.35,"1,271,503,410"
2000,Australia,16,25,17,58,900165537707.341,"18,835,722"
2000,Germany,13,17,26,56,3176872812245.88,"82,183,670"
2000,France,13,14,11,38,2406838087998.32,"61,286,728"
2000,Italy,13,8,13,34,2101931939042.18,"57,784,371"
2000,Cuba,11,11,7,29,40532156423.1685,"11,146,712"
2000,Great Britain,11,10,7,28,,
2000,South Korea,8,10,10,28,,
2000,Romania,11,6,9,26,122225415551.961,"22,262,406"
2000,Netherlands,12,9,4,25,758356688950.764,"15,930,182"
2000,Ukraine,3,10,10,23,102754675134.835,"49,013,834"
2000,Japan,5,8,5,18,5377007127014.02,"126,771,901"
2000,Belarus,3,3,11,17,31611178883.8695,"10,033,392"
2000,Hungary,8,6,3,17,116318944982.828,"10,147,425"
2000,Poland,6,5,3,14,337018207143.568,"38,654,162"
2000,Canada,3,3,8,14,1406913998529.75,"31,099,560"
2000,Bulgaria,5,6,2,13,35524705563.8283,"7,908,665"
2000,Greece,4,6,3,13,272175455326.753,"10,925,795"
2000,Sweden,4,5,3,12,411654200414.867,"8,924,354"
2000,Brazil,0,6,6,12,1607729271032.29,"175,969,492"
2000,Spain,3,3,5,11,1229910878223.45,"40,589,004"
2000,Norway,4,3,3,10,379993390464.635,"4,492,401"
2000,Jamaica,0,6,3,9,12763085337.6409,"2,810,680"
2000,Switzerland,1,6,2,9,494345122120.216,"7,277,251"
2000,Czech Republic,2,3,3,8,158841359810.454,
2000,Ethiopia,4,1,3,8,14374794288.769,"62,891,069"
2000,Kenya,2,3,2,7,27337613463.7899,"30,922,122"
2000,Kazakhstan,3,4,0,7,83311937130.6468,"15,687,251"
2000,Georgia,0,0,6,6,6998485720.69797,"4,818,805"
2000,Denmark,2,3,1,6,302077924103.075,"5,337,416"
2000,Mexico,1,2,3,6,911151773828.818,"99,775,434"
2000,Indonesia,1,3,2,6,491078136159.837,"214,090,575"
2000,Turkey,3,0,2,5,521387961745.149,"65,978,547"
2000,Slovakia,1,3,1,5,,"5,400,316"
2000,Morocco,0,1,4,5,63656943581.251,"28,491,421"
2000,Lithuania,2,0,3,5,27594931858.1505,"3,489,407"
2000,South Africa,0,2,3,5,284356442826.556,"45,143,676"
2000,Algeria,1,1,3,5,120125920931.173,"30,634,947"
2000,Belgium,0,2,3,5,422530458033.305,"10,263,618"
2000,Chinese Taipei,0,1,4,5,,
2000,Argentina,0,2,2,4,258281789127.305,"37,335,675"
2000,Uzbekistan,1,1,2,4,21843958958.3906,"25,041,820"
2000,Iran,3,0,1,4,,"66,482,211"
2000,North Korea,0,1,3,4,,
2000,Finland,2,1,1,4,218392295141.416,"5,168,595"
2000,New Zealand,1,0,3,4,122735467606.099,"3,802,400"
2000,Nigeria,1,2,0,3,206684534275.905,"125,580,732"
2000,Austria,2,1,0,3,346387257223.224,"8,113,392"
2000,Azerbaijan,2,0,1,3,16057770026.7758,"8,463,076"
2000,Thailand,1,0,2,3,239058711719.124,"61,146,322"
2000,Bahamas,2,0,1,3,,
2000,Estonia,1,0,2,3,15927040858.0414,"1,379,671"
2000,Yugoslavia,1,1,1,3,,
2000,Latvia,1,1,1,3,18720689361.2743,"2,368,427"
2000,Costa Rica,0,0,2,2,26144234370.1645,"3,882,234"
2000,Croatia,1,0,1,2,50932201746.0895,"4,390,263"
2000,Portugal,0,0,2,2,227408192515.552,"10,361,404"
2000,Saudi Arabia,0,1,1,2,364070454426.667,"21,361,821"
2000,Moldova,0,1,1,2,4837680703.66857,"4,180,215"
2000,Slovenia,2,0,0,2,39483849698.5294,"2,011,242"
2000,Trinidad and Tobago,0,1,1,2,13942348940.4975,"1,261,135"
2000,Macedonia,0,0,1,1,,
2000,Vietnam,0,1,0,1,69037326105.908,"79,451,866"
2000,Ireland,0,1,0,1,187128802633.068,"3,822,196"
2000,Uruguay,0,1,0,1,26512908469.9633,"3,219,796"
2000,Armenia,0,0,1,1,5345387542.93892,"3,100,044"
2000,Kuwait,0,0,1,1,76154795184.9267,"1,972,225"
2000,Kyrgyzstan,0,0,1,1,,"4,937,123"
2000,Mozambique,1,0,0,1,5684162363.79798,"18,498,198"
2000,Barbados,0,0,1,1,4056812032.13438,"274,880"
2000,Sri Lanka,0,1,0,1,35079926055.4816,"19,041,167"
2000,Iceland,0,0,1,1,11020792658.5685,"281,038"
2000,Cameroon,1,0,0,1,19332618830.0545,"15,836,469"
2000,Chile,0,0,1,1,153937081014.428,"15,174,572"
2000,Colombia,1,0,0,1,200646110923.516,"40,319,332"
2000,Israel,0,0,1,1,174245451306.842,"6,112,320"
2000,Qatar,0,0,1,1,40139043103.6418,"639,897"
2000,India,0,0,1,1,950312739671.573,"1,049,692,922"
2004,United States,36,39,26,101,14741688498100.0,"292,805,298"
2004,Russia,28,26,36,90,,"144,966,251"
2004,China,32,17,14,63,4015044510537.74,"1,299,116,861"
2004,Australia,17,16,17,50,1023370338682.13,"19,777,611"
2004,Germany,13,16,20,49,3332692329600.37,"82,487,209"
2004,Japan,16,9,12,37,5752853952769.92,"127,668,360"
2004,France,11,9,13,33,2598956033979.84,"62,708,105"
2004,Italy,10,11,11,32,2202038561569.49,"58,716,001"
2004,Great Britain,9,9,12,30,,
2004,South Korea,9,12,9,30,,
2004,Cuba,9,7,11,27,55451844706.1798,"11,260,208"
2004,Netherlands,4,9,9,22,817858911939.74,"16,266,339"
2004,Ukraine,8,5,9,22,139607969151.671,"47,342,447"
2004,Spain,3,11,6,20,1414736959945.11,"43,000,157"
2004,Romania,8,5,6,19,156187254733.537,"21,573,639"
2004,Hungary,8,6,3,17,137506649850.561,"10,072,608"
2004,Greece,6,6,4,16,321534411242.933,"10,999,476"
2004,Belarus,2,5,6,13,45382541170.3599,"9,855,646"
2004,Canada,3,6,3,12,1563902678608.51,"32,134,761"
2004,Bulgaria,2,1,9,12,45520779748.2063,"7,665,632"
2004,Turkey,3,3,5,11,704919602071.452,"69,583,061"
2004,Poland,3,2,5,10,403236825523.165,"38,574,205"
2004,Brazil,5,2,3,10,1845117253979.08,"185,755,950"
2004,Czech Republic,1,3,5,9,196523032214.994,
2004,Denmark,2,1,5,8,331090561914.626,"5,400,727"
2004,Thailand,3,1,4,8,297864826688.794,"63,442,956"
2004,Kazakhstan,1,4,3,8,121197091344.948,"15,988,620"
2004,Sweden,4,2,1,7,473150714176.123,"9,046,267"
2004,Kenya,1,4,2,7,33349876084.3647,"34,764,895"
2004,Ethiopia,2,3,2,7,19795942246.2104,"69,811,259"
2004,Austria,2,4,1,7,379958397501.957,"8,263,235"
2004,Iran,2,2,2,6,,"69,600,627"
2004,Argentina,2,0,4,6,360465082297.96,"38,945,354"
2004,Norway,5,0,1,6,418934364461.602,"4,593,414"
2004,Slovakia,2,2,2,6,,"5,405,580"
2004,South Africa,1,3,2,6,340284178369.573,"47,658,777"
2004,New Zealand,3,2,0,5,141870639750.14,"4,008,166"
2004,North Korea,0,4,1,5,,
2004,Switzerland,1,1,3,5,545008791663.243,"7,415,374"
2004,Uzbekistan,2,1,2,5,28114501576.7622,"26,292,535"
2004,Jamaica,2,1,2,5,13918122244.4502,"2,852,841"
2004,Azerbaijan,1,0,4,5,33268154327.4079,"8,737,808"
2004,Chinese Taipei,2,2,1,5,,
2004,Croatia,1,2,2,5,61008204110.5857,"4,441,435"
2004,Egypt,1,1,3,5,,"71,310,598"
2004,Latvia,0,4,0,4,27237668361.0711,"2,283,318"
2004,Mexico,0,3,1,4,1026912659604.72,"105,230,503"
2004,Indonesia,1,1,2,4,602626663572.804,"227,321,651"
2004,Slovenia,0,1,3,4,46561862055.1658,"2,016,922"
2004,Georgia,2,2,0,4,9860180665.4323,"4,742,862"
2004,Estonia,0,1,2,3,21932809902.7181,"1,340,354"
2004,Belgium,1,0,2,3,461812130895.081,"10,413,347"
2004,Chile,2,0,1,3,193127635486.362,"15,828,679"
2004,Lithuania,1,2,0,3,37605683774.4175,"3,384,473"
2004,Zimbabwe,1,1,1,3,11323673004.4172,"13,087,806"
2004,Portugal,0,2,1,3,234713145002.77,"10,557,290"
2004,Morocco,2,1,0,3,78544623310.6445,"29,903,483"
2004,Finland,0,2,0,2,247575988035.367,"5,220,193"
2004,Venezuela,0,0,2,2,,"25,926,640"
2004,Bahamas,1,0,1,2,,
2004,Colombia,0,0,2,2,245554885937.816,"42,012,843"
2004,Nigeria,0,0,2,2,273634239781.634,"140,534,504"
2004,Serbia and Montenegro,0,2,0,2,,
2004,Israel,1,0,1,2,201256400109.656,"6,615,265"
2004,Cameroon,1,0,0,1,22784042334.906,"17,678,398"
2004,Mongolia,0,0,1,1,5702204050.40528,"2,574,146"
2004,United Arab Emirates,1,0,0,1,282684947637.849,"3,819,555"
2004,Syria,0,0,1,1,,"18,082,580"
2004,Trinidad and Tobago,0,0,1,1,20709938758.2907,"1,283,298"
2004,India,0,1,0,1,1290107534501.3,"1,121,076,540"
2004,Dominican Republic,1,0,0,1,44523614464.9785,"8,730,936"
2004,Hong Kong,0,1,0,1,,"6,847,993"
2004,Paraguay,0,1,0,1,21895565804.2224,"5,825,838"
2004,Eritrea,0,0,1,1,2179437333.32658,"4,551,365"
2008,United States,36,39,37,112,14992052727000.0,"304,093,966"
2008,China,48,22,30,100,6087164527421.24,"1,326,206,773"
2008,Russia,24,13,23,60,,"143,359,355"
2008,Great Britain,19,13,19,51,,
2008,Australia,14,15,17,46,1146138465603.81,"21,040,262"
2008,France,7,16,20,43,2642609548930.36,"64,250,843"
2008,Germany,16,11,14,41,3417094562648.95,"82,065,369"
2008,South Korea,13,11,8,32,,
2008,Cuba,3,10,17,30,64328000000.0,"11,258,336"
2008,Italy,8,9,10,27,2125058244242.92,"60,091,305"
2008,Japan,9,8,8,25,5700098114744.41,"127,826,531"
2008,Ukraine,7,4,11,22,136013155905.036,"46,155,640"
2008,Canada,3,9,8,20,1613542812589.39,"33,393,043"
2008,Spain,5,11,3,19,1431616749640.29,"45,910,365"
2008,Brazil,3,4,10,17,2208871646202.82,"194,195,572"
2008,Netherlands,7,5,4,16,846554894931.084,"16,410,055"
2008,Kenya,6,4,6,16,40000088346.8041,"39,310,323"
2008,Belarus,3,4,7,14,58665088956.0255,"9,712,051"
2008,Jamaica,5,4,2,11,13200286270.4683,"2,847,477"
2008,Poland,4,5,2,11,479321460551.189,"38,556,061"
2008,Hungary,3,5,2,10,130922638689.071,"10,027,594"
2008,Norway,3,5,1,9,429130952709.224,"4,770,097"
2008,Romania,4,1,4,9,166225180150.414,"20,888,685"
2008,New Zealand,3,2,4,9,146583831538.331,"4,171,974"
2008,Kazakhstan,2,3,4,9,148047348240.643,"16,645,324"
2008,Georgia,3,2,2,7,11638500813.5555,"4,823,790"
2008,Denmark,2,2,3,7,321995279401.502,"5,491,488"
2008,Czech Republic,3,3,1,7,207477857918.919,
2008,Ethiopia,4,2,1,7,29933790334.3418,"77,695,164"
2008,Switzerland,2,1,4,7,583782977866.405,"7,700,222"
2008,Slovakia,3,3,0,6,,"5,415,203"
2008,Thailand,2,2,2,6,341105009515.333,"65,430,431"
2008,Argentina,2,0,4,6,423627422092.49,"40,531,409"
2008,Azerbaijan,1,1,4,6,52902703376.1056,"9,120,355"
2008,North Korea,2,2,2,6,,
2008,Indonesia,1,1,4,6,755094160363.073,"240,064,968"
2008,Sweden,0,4,1,5,488909078695.423,"9,273,133"
2008,Croatia,0,2,3,5,59865977191.7061,"4,434,262"
2008,Nigeria,0,3,2,5,363359886203.409,"157,143,322"
2008,Turkey,1,1,3,5,771901768870.083,"73,020,415"
2008,Bulgaria,1,1,3,5,50610058210.3696,"7,465,356"
2008,Lithuania,0,3,2,5,37120517693.8622,"3,195,990"
2008,Armenia,0,1,4,5,9260284937.79782,"3,076,467"
2008,Slovenia,1,2,2,5,48013606745.4803,"2,056,915"
2008,Uzbekistan,0,1,3,4,39332770928.9426,"27,746,697"
2008,Mongolia,2,2,0,4,7189481824.07288,"2,702,400"
2008,Mexico,2,0,2,4,1057801295584.05,"110,876,639"
2008,Zimbabwe,1,3,0,4,12041655200.0,"13,119,805"
2008,Chinese Taipei,1,1,2,4,,
2008,Finland,1,1,2,4,247799815768.477,"5,304,716"
2008,Greece,0,2,1,3,299361576558.217,"10,996,346"
2008,Latvia,1,1,1,3,23757368290.0955,"2,197,506"
2008,Colombia,0,2,1,3,286103648654.545,"43,168,865"
2008,Kyrgyzstan,0,1,2,3,,"5,298,684"
2008,Ireland,0,1,2,3,222148757313.006,"4,517,709"
2008,Serbia,0,1,2,3,41819468691.8251,"7,307,359"
2008,India,1,0,2,3,1675615312693.42,"1,188,680,299"
2008,Austria,0,1,2,3,391892746544.69,"8,406,796"
2008,Dominican Republic,1,1,0,2,53982886258.2205,"9,219,827"
2008,Trinidad and Tobago,1,1,0,2,22157948396.2042,"1,308,122"
2008,Egypt,0,0,2,2,,"77,777,097"
2008,Belgium,2,0,0,2,483548031197.108,"10,692,800"
2008,Estonia,1,1,0,2,19490936349.1753,"1,311,467"
2008,Tajikistan,0,1,1,2,5642178579.58438,"7,142,391"
2008,Bahamas,0,1,1,2,,
2008,Iran,1,0,1,2,,"73,119,798"
2008,Algeria,0,1,1,2,161207268655.392,"34,619,260"
2008,Morocco,0,1,1,2,93216746661.5977,"31,474,893"
2008,Portugal,1,1,0,2,238303443425.21,"10,635,102"
2008,Cameroon,1,0,0,1,26143818509.6421,"19,746,892"
2008,Tunisia,1,0,0,1,44050929160.2627,"10,307,653"
2008,Venezuela,0,0,1,1,,"27,819,427"
2008,Togo,0,0,1,1,3426022205.75557,"5,850,173"
2008,Chile,0,1,0,1,218537551220.071,"16,441,035"
2008,Vietnam,0,1,0,1,115931749697.241,"88,230,616"
2008,Malaysia,0,1,0,1,255016609232.871,"27,924,658"
2008,Sudan,0,1,0,1,65634109236.7736,"33,173,036"
2008,Ecuador,0,1,0,1,69555367000.0,"14,488,773"
2008,South Africa,0,1,0,1,375348316917.75,"50,394,494"
2008,Mauritius,0,0,1,1,10003670690.3497,"1,268,899"
2008,Singapore,0,1,0,1,239809387605.427,"5,046,845"
2008,Samoa,0,1,0,1,643046733.391126,"189,503"
2008,Iceland,0,1,0,1,13683689802.2771,"317,363"
2008,Panama,1,0,0,1,29440300000.0,"3,374,475"
2008,Israel,0,0,1,1,233732926323.391,"7,115,836"
2008,Moldova,0,0,1,1,6974960345.3712,"3,933,442"
2008,Afghanistan,0,0,1,1,15856574731.4411,"27,703,539"
2012,United States,46,28,30,104,16242526401300.0,"313,877,662"
2012,China,38,31,22,91,8317255434071.39,"1,355,524,732"
2012,Russia,20,20,28,68,,"143,645,489"
2012,Great Britain,29,17,19,65,,
2012,Germany,11,20,13,44,3654924349507.01,"81,862,920"
2012,Japan,7,14,17,38,5916317345749.24,"127,250,763"
2012,France,11,11,13,35,2750675573588.84,"65,634,194"
2012,Australia,8,15,12,35,1284254470331.22,"22,563,165"
2012,South Korea,13,9,8,30,,
2012,Italy,8,9,11,28,2043486014884.01,"61,303,175"
2012,Netherlands,6,6,8,20,861816072387.648,"16,713,096"
2012,Ukraine,5,4,10,19,134331493522.859,"45,491,540"
2012,Spain,4,10,5,19,1371017708643.57,"46,444,355"
2012,Hungary,8,4,6,18,139309419213.17,"9,944,323"
2012,Canada,2,6,10,18,1782827583707.39,"34,974,489"
2012,Brazil,3,5,9,17,2423271865109.14,"201,350,896"
2012,Cuba,5,3,7,15,70729490571.2058,"11,261,613"
2012,Kenya,2,4,7,13,49506417103.7163,"44,323,013"
2012,Iran,7,5,1,13,,"76,681,210"
2012,New Zealand,6,2,5,13,163137970111.525,"4,336,624"
2012,Jamaica,4,5,3,12,13505052829.4645,"2,827,200"
2012,Czech Republic,4,3,4,11,214124330763.29,
2012,Kazakhstan,3,1,7,11,184051677947.507,"17,571,722"
2012,Poland,3,2,6,11,535792126819.885,"38,632,423"
2012,Belarus,2,5,3,10,64590481690.9209,"9,653,837"
2012,Colombia,1,3,5,9,349512460297.654,"44,381,863"
2012,Azerbaijan,2,2,5,9,57902587621.89,"9,614,435"
2012,Denmark,2,4,3,9,335436569747.025,"5,592,472"
2012,Ethiopia,3,2,3,8,44085556179.422,"86,859,533"
2012,Sweden,1,4,3,8,519891606167.582,"9,573,255"
2012,Mexico,1,3,4,8,1184180145123.71,"117,627,103"
2012,North Korea,4,0,3,7,,
2012,Romania,2,4,1,7,185277804086.669,"20,252,280"
2012,Georgia,1,2,3,6,14355383493.2391,"4,950,269"
2012,South Africa,4,1,1,6,413604477764.046,"52,995,725"
2012,India,0,2,4,6,2125024908808.5,"1,251,839,015"
2012,Croatia,3,1,2,6,57952302691.888,"4,389,754"
2012,Ireland,1,1,4,6,245809905106.814,"4,651,890"
2012,Mongolia,0,2,3,5,11408652157.2819,"2,869,801"
2012,Lithuania,2,0,3,5,43796470015.265,"2,973,159"
2012,Switzerland,2,2,0,4,625701684969.818,"8,077,542"
2012,Norway,2,1,1,4,458626161483.524,"5,021,107"
2012,Serbia,1,1,2,4,42912989858.1498,"7,159,029"
2012,Slovakia,0,1,3,4,,"5,440,777"
2012,Thailand,0,2,2,4,382525395708.79,"67,045,539"
2012,Trinidad and Tobago,1,1,2,4,22606161202.1468,"1,334,316"
2012,Slovenia,1,1,2,4,47874936326.2899,"2,092,758"
2012,Argentina,1,1,2,4,443707073929.401,"42,216,144"
2012,Egypt,0,3,1,4,,"85,806,339"
2012,Tunisia,2,0,1,3,47599273438.5916,"10,772,441"
2012,Belgium,0,1,2,3,500592443806.033,"11,058,132"
2012,Turkey,1,1,1,3,1025466784990.27,"76,335,994"
2012,Finland,0,2,1,3,247075355590.897,"5,405,387"
2012,Uzbekistan,0,0,3,3,53345005658.0365,"29,557,133"
2012,Indonesia,0,2,1,3,942184637117.359,"252,247,464"
2012,Bulgaria,0,2,1,3,52802761608.2307,"7,308,614"
2012,Singapore,0,0,2,2,289862763533.356,"5,318,078"
2012,Armenia,0,1,1,2,11123101341.3964,"3,067,011"
2012,Qatar,0,0,2,2,161225944072.686,"1,952,262"
2012,Puerto Rico,0,1,1,2,96592767902.4776,"3,636,205"
2012,Dominican Republic,1,1,0,2,64555004673.9627,"9,691,122"
2012,Chinese Taipei,1,0,1,2,,
2012,Estonia,0,1,1,2,22942757718.395,"1,288,868"
2012,Greece,0,0,2,2,245794711441.894,"10,948,200"
2012,Malaysia,0,1,1,2,314317779640.495,"29,982,958"
2012,Latvia,1,0,1,2,27432357431.7187,"2,051,103"
2012,Uganda,1,0,0,1,24965074811.1287,"32,815,387"
2012,Venezuela,1,0,0,1,,"29,486,420"
2012,Tajikistan,0,0,1,1,7464481210.4014,"7,872,533"
2012,Afghanistan,0,0,1,1,19477070577.8584,"30,412,510"
2012,Saudi Arabia,0,0,1,1,651957609840.0,"29,493,088"
2012,Portugal,0,1,0,1,223971165762.163,"10,591,764"
2012,Morocco,0,0,1,1,108463202314.752,"33,052,739"
2012,Montenegro,0,1,0,1,4380723550.42906,"622,079"
2012,Kuwait,0,0,1,1,137150383810.188,"2,646,670"
2012,Algeria,1,0,0,1,182889354514.369,"37,412,252"
2012,Hong Kong,0,0,1,1,,"7,050,104"
2012,Guatemala,0,1,0,1,47896442426.645,"14,823,189"
2012,Grenada,1,0,0,1,843718324.581439,"109,088"
2012,Gabon,0,1,0,1,17834619899.8015,"1,743,383"
2012,Cyprus,0,1,0,1,23173192052.9801,"1,138,183"
2012,Cameroon,0,0,1,1,31763379465.2944,"22,073,688"
2012,Botswana,0,1,0,1,16425389502.779,"2,044,538"
2012,Bahrain,1,0,0,1,29922841390.6393,"1,248,334"
2012,Bahamas,1,0,0,1,,
2012,Vietnam,0,0,1,1,144834688912.566,"92,697,293"
2016,United States,46,37,38,121,17844274747700.0,"323,071,755"
2016,China,26,18,26,70,10800568391746.1,"1,382,148,409"
2016,Great Britain,27,23,17,67,,
2016,Russia,19,17,20,56,,"144,133,052"
2016,Germany,17,10,15,42,3939226614470.55,"83,823,029"
2016,France,10,18,14,42,2924903217192.47,"66,809,791"
2016,Japan,12,8,21,41,6189748011270.24,"126,461,255"
2016,Australia,8,11,10,29,1422550005324.64,"23,980,152"
2016,Italy,8,12,8,28,2138766169807.78,"61,499,222"
2016,Canada,4,3,15,22,1904173807117.24,"36,404,804"
2016,South Korea,9,3,9,21,,
2016,Netherlands,8,7,4,19,948100838782.427,"16,987,697"
2016,Brazil,7,6,6,19,2309659590893.59,"208,323,342"
2016,New Zealand,4,9,5,18,185649634531.9,"4,614,016"
2016,Azerbaijan,1,7,10,18,57357249337.7948,"10,124,248"
2016,Kazakhstan,3,5,10,18,204067060293.706,"18,580,056"
2016,Spain,7,4,6,17,1548723684488.31,"46,159,139"
2016,Hungary,8,3,4,15,161218871563.44,"10,078,984"
2016,Denmark,2,6,7,15,364840483457.28,"5,733,361"
2016,Kenya,6,6,1,13,61781234460.6182,"48,932,882"
2016,Uzbekistan,4,2,7,13,66785463953.1149,"31,630,582"
2016,Ukraine,2,5,4,11,131467311860.477,"44,161,657"
2016,Poland,2,3,6,11,631952707856.598,"38,514,598"
2016,Sweden,2,6,3,11,582804342166.04,"9,961,459"
2016,Jamaica,6,3,2,11,14209550470.9176,"2,814,150"
2016,Cuba,5,2,4,11,,"11,179,836"
2016,South Africa,2,6,2,10,429875731351.897,"55,372,293"
2016,Croatia,5,3,2,10,64899927755.5475,"4,313,911"
2016,Czech Republic,1,2,7,10,248204259552.577,
2016,Belarus,1,4,4,9,63974173257.5273,"9,690,871"
2016,Ethiopia,1,2,5,8,62291386041.403,"97,276,892"
2016,Serbia,2,4,2,8,48040463522.8875,"7,015,855"
2016,Iran,3,1,4,8,,"81,004,837"
2016,Turkey,1,3,4,8,1236994415484.57,"80,232,150"
2016,Colombia,3,2,3,8,382216044545.046,"45,425,599"
2016,Georgia,2,1,4,7,16674521685.4626,"4,978,150"
2016,North Korea,2,3,2,7,,
2016,Switzerland,3,2,2,7,671241684579.846,"8,354,268"
2016,Thailand,2,2,2,6,441678233315.657,"68,346,863"
2016,Greece,3,1,2,6,252723303555.798,"10,703,982"
2016,Belgium,2,2,2,6,533218198385.386,"11,401,905"
2016,Malaysia,0,4,1,5,381795038961.845,"31,647,285"
2016,Mexico,0,3,2,5,1310528918811.03,"123,576,658"
2016,Norway,0,0,4,4,489564184707.018,"5,238,793"
2016,Romania,1,1,2,4,224629098584.481,"19,722,552"
2016,Slovenia,1,2,1,4,55320605336.0414,"2,100,372"
2016,Slovakia,2,2,0,4,,"5,463,996"
2016,Argentina,3,1,0,4,446730617131.025,"43,886,223"
2016,Armenia,1,3,0,4,13007610290.7282,"3,051,140"
2016,Lithuania,0,1,3,4,49290096837.1762,"2,855,139"
2016,Venezuela,0,2,1,3,,"30,757,956"
2016,Indonesia,1,2,0,3,1146844815417.11,"263,204,105"
2016,Bulgaria,0,1,2,3,60767158521.7273,"7,144,269"
2016,Egypt,0,0,3,3,,"95,228,450"
2016,Tunisia,0,0,3,3,50910302100.9603,"11,284,841"
2016,Chinese Taipei,1,0,2,3,,
2016,Algeria,0,2,0,2,203353978108.49,"40,652,703"
2016,India,0,1,1,2,2846127730148.26,"1,312,486,077"
2016,Ivory Coast,1,0,1,2,,
2016,Bahamas,1,0,1,2,,
2016,Bahrain,1,1,0,2,33646560943.3779,"1,378,755"
2016,Independent Olympic Athletes,1,0,1,2,,
2016,Ireland,0,2,0,2,373141461521.609,"4,808,974"
2016,Israel,0,0,2,2,309055479312.373,"8,242,458"
2016,Vietnam,1,1,0,2,187686812137.294,"97,355,565"
2016,Mongolia,0,1,1,2,13307759596.1193,"3,030,679"
2016,Kosovo,1,0,0,1,7738507887.30315,"1,882,352"
2016,Fiji,1,0,0,1,4292423440.1143,"914,582"
2016,Austria,0,0,1,1,444564007898.326,"8,710,175"
2016,Philippines,0,1,0,1,322300707148.301,"103,351,132"
2016,Morocco,0,0,1,1,122867726652.452,"34,591,211"
2016,United Arab Emirates,0,0,1,1,392773315180.395,"9,432,801"
2016,Burundi,0,1,0,1,2355586067.90637,"10,720,731"
2016,Dominican Republic,0,0,1,1,82370450861.4939,"10,123,067"
2016,Estonia,0,0,1,1,26350212987.4088,"1,258,272"
2016,Trinidad and Tobago,0,0,1,1,21249443809.4289,"1,359,247"
2016,Tajikistan,1,0,0,1,9765396816.15014,"8,747,810"
2016,Jordan,1,0,0,1,32227101327.9764,"10,040,615"
2016,Finland,0,0,1,1,267320507829.469,"5,499,022"
2016,Grenada,0,1,0,1,1026006951.86419,"111,300"
2016,Portugal,0,0,1,1,244064957343.733,"10,400,888"
2016,Niger,0,1,0,1,8943964597.41412,"19,637,375"
2016,Puerto Rico,1,0,0,1,87357573179.4529,"3,411,561"
2016,Qatar,0,1,0,1,175863478348.24,"2,259,867"
2016,Singapore,1,0,0,1,328440881504.009,"5,576,352"
2016,Nigeria,0,0,1,1,469376777269.159,"193,466,758"
2020,United States,39,41,33,113,,"331,511,512"
2020,China,38,32,18,88,,"1,404,031,889"
2020,ROC,20,28,23,71,,
2020,Great Britain,22,21,22,65,,
2020,Japan,27,14,17,58,,"125,135,727"
2020,Australia,17,7,22,46,,"25,467,706"
2020,Italy,10,10,20,40,,"61,337,765"
2020,Germany,10,11,16,37,,"84,498,245"
2020,Netherlands,10,12,14,36,,"17,400,890"
2020,France,10,12,11,33,,"67,791,837"
2020,Canada,7,6,11,24,,"37,649,603"
2020,Brazil,7,6,8,21,,"214,752,313"
2020,South Korea,6,4,10,20,,
2020,New Zealand,7,6,7,20,,"4,925,334"
2020,Hungary,6,7,7,20,,"10,026,575"
2020,Ukraine,1,6,12,19,,"43,508,029"
2020,Spain,3,8,6,17,,"47,041,387"
2020,Cuba,7,3,5,15,,"11,058,573"
2020,Poland,4,5,5,14,,"38,375,246"
2020,Turkey,2,2,9,13,,"82,009,212"
2020,Switzerland,3,4,6,13,,"8,585,698"
2020,Chinese Taipei,2,4,6,12,,
2020,Czech Republic,4,4,3,11,,
2020,Denmark,3,4,4,11,,"5,868,927"
2020,Kenya,4,4,2,10,,"53,513,653"
2020,Serbia,3,1,5,9,,"6,856,660"
2020,Jamaica,4,1,4,9,,"2,815,048"
2020,Sweden,3,6,0,9,,"10,382,678"
2020,Georgia,2,5,1,8,,"4,997,628"
2020,Norway,4,2,2,8,,"5,381,527"
2020,Kazakhstan,0,0,8,8,,"19,513,854"
2020,Croatia,3,3,2,8,,"4,229,585"
2020,India,1,2,4,7,,"1,369,541,070"
2020,Belarus,1,3,3,7,,"9,636,175"
2020,Austria,1,1,5,7,,"8,856,348"
2020,Azerbaijan,0,3,4,7,,"10,464,719"
2020,Iran,3,2,2,7,,"84,982,541"
2020,Belgium,3,1,3,7,,"11,708,235"
2020,Bulgaria,3,1,2,6,,"6,965,462"
2020,Hong Kong,1,2,3,6,,"7,248,206"
2020,Egypt,1,1,4,6,,"103,994,537"
2020,Indonesia,1,1,3,5,,"272,856,400"
2020,Slovenia,3,1,1,5,,"2,102,452"
2020,Uzbekistan,3,0,2,5,,"34,014,838"
2020,Dominican Republic,0,3,2,5,,"10,516,103"
2020,Colombia,0,4,1,5,,"48,419,737"
2020,Romania,1,3,0,4,,"18,986,068"
2020,Philippines,1,2,1,4,,"110,461,801"
2020,Portugal,1,1,2,4,,"10,288,283"
2020,Uganda,2,1,1,4,,"43,249,944"
2020,Slovakia,1,2,1,4,,"5,492,134"
2020,Mexico,0,0,4,4,,"128,092,570"
2020,Mongolia,0,1,3,4,,"3,168,648"
2020,Venezuela,1,3,0,4,,"28,612,153"
2020,Armenia,0,2,2,4,,"3,021,483"
2020,Ethiopia,1,1,2,4,,"107,882,961"
2020,Greece,2,1,1,4,,"10,604,841"
2020,Ireland,2,0,2,4,,"5,030,214"
2020,Israel,2,0,2,4,,"8,829,355"
2020,San Marino,0,1,2,3,,"34,247"
2020,Ecuador,2,1,0,3,,"17,550,613"
2020,South Africa,1,2,0,3,,"58,012,938"
2020,Qatar,2,0,1,3,,"2,447,179"
2020,Argentina,0,1,2,3,,"45,479,650"
2020,Kyrgyzstan,0,2,1,3,,"5,963,777"
2020,Latvia,1,0,1,2,,"1,883,186"
2020,Fiji,1,0,1,2,,"935,139"
2020,Jordan,0,1,1,2,,"10,819,966"
2020,Finland,0,0,2,2,,"5,572,355"
2020,Thailand,1,0,1,2,,"69,291,926"
2020,Tunisia,1,1,0,2,,"11,719,458"
2020,Malaysia,0,1,1,2,,"33,164,013"
2020,Kosovo,2,0,0,2,,"1,931,888"
2020,Bahamas,2,0,0,2,,
2020,Nigeria,0,1,1,2,,"213,986,428"
2020,Estonia,1,0,1,2,,"1,228,296"
2020,Turkmenistan,0,1,0,1,,"5,522,684"
2020,Botswana,0,0,1,1,,"2,316,910"
2020,Burkina Faso,0,0,1,1,,"20,833,136"
2020,Bermuda,1,0,0,1,,"71,818"
2020,Bahrain,0,1,0,1,,"1,504,665"
2020,Syria,0,0,1,1,,"19,392,460"
2020,North Macedonia,0,1,0,1,,"2,125,463"
2020,Moldova,0,0,1,1,,"3,587,186"
2020,Ghana,0,0,1,1,,"31,643,281"
2020,Morocco,1,0,0,1,,"36,055,311"
2020,Saudi Arabia,0,1,0,1,,"34,223,743"
2020,Grenada,0,0,1,1,,"113,165"
2020,Namibia,0,1,0,1,,"2,627,111"
2020,Kuwait,0,0,1,1,,"2,995,271"
2020,Puerto Rico,1,0,0,1,,"3,190,410"
2020,Ivory Coast,0,0,1,1,,
2020,Lithuania,0,1,0,1,,"2,739,816"
